Jared	Peterson
Kelli	Soto
Guadalupe	Johnson
Charlene	Berry
Norma	Palmer
Michael	Massey
Ricardo	Russell
Leticia	Harmon
Terence	Francis
Martin	Barber
Wilbert	Simon
Benny	Newton
Lydia	Cook
Raymond	Hammond
Mercedes	Santiago
Clinton	Coleman
Robin	Clarke
Katie	Bryant
Doug	Young
Kendra	Figueroa
Gina	Luna
Jennifer	Klein
Cristina	White
Tanya	Greer
Omar	Sharp
Kerry	Willis
Mitchell	Ingram
Bridget	Rice
Mae	Stevenson
Clifton	Hudson
Devin	Norton
Carol	Estrada
Willie	Wood
Tommie	Mitchell
Lela	Casey
Kristina	Owens
Hugo	Moran
Lena	Snyder
Horace	Freeman
Luis	Warren
Virgil	Gonzalez
Phillip	Webster
Delbert	Salazar
Melba	Wright
Gwen	Jefferson
Erick	Mckenzie
Alice	Benson
Chelsea	Pena
John	Boone
Norman	Sutton
Corey	Day
Dianne	Henry
Tommy	Graham
Rhonda	Rivera
Darla	Martinez
Jessica	Burgess
Ryan	Nunez
Blake	Vasquez
Loretta	Gibbs
Mario	Franklin
Otis	Steele
Jerry	Bishop
Susan	Rogers
Marcos	Rose
Jamie	Summers
Rafael	Wagner
Lindsey	Townsend
Evan	Ellis
Ramon	Lyons
Randal	Cohen
Hope	Patton
Paulette	Stone
Carl	Sherman
Estelle	Bush
Cora	Chavez
Glenn	Joseph
Boyd	Vaughn
Nettie	Lucas
Lorene	Strickland
Shelia	Cunningham
Kristine	Potter
Christy	Gomez
Essie	Nguyen
Samantha	Turner
Flora	Johnston
Marion	Wilkins
Eileen	Burke
Lucy	Clark
Marilyn	Cruz
Mable	Carter
Elsie	Wilson
Megan	Moore
Thelma	Ross
Winston	Drake
Ignacio	Montgomery
Sara	Fleming
Ellen	Wolfe
Pauline	Weber
Saul	Reeves
Cecilia	Fowler